|H, -, -, -, G, G, G, 
|-, -, -, -, -, -, -, 
|-, -, -, -, -, -, -, 
|-, -, -, -, -, -, -, 
|I, I, I, -, P, P, P, 
